"Team","Year","W","L","PTS","PTS.G","oppPTS","Playoffs","G","MP","FG","FGA","FG_P","X3P","X3PA","X3P_P","X2P","X2PA","X2P_P","FT","FTA","FT_P","ORB","DRB","TRB","AST","STL","BLK","TOV","PF"
"Atlanta Hawks",2010,53,29,8338,101.7,7956,1,82,19855,3181,6801,0.468,524,1455,0.36,2657,5346,0.497,1452,1914,0.759,969,2451,3420,1789,592,413,980,1632
"Boston Celtics",2010,50,32,8136,99.2,7836,1,82,19780,3039,6294,0.483,499,1433,0.348,2540,4861,0.523,1559,2090,0.746,716,2449,3165,1930,701,402,1219,1816
"Charlotte Bobcats",2010,44,38,7813,95.3,7693,1,82,19880,2858,6306,0.453,460,1331,0.346,2398,4975,0.482,1637,2180,0.751,858,2490,3348,1658,632,446,1290,1597
"Chicago Bulls",2010,41,41,7993,97.5,8127,1,82,19905,3081,6825,0.451,352,1066,0.33,2729,5759,0.474,1479,1962,0.754,937,2715,3652,1704,531,478,1175,1648
"Cleveland Cavaliers",2010,61,21,8373,102.1,7838,1,82,19780,3101,6391,0.485,602,1582,0.381,2499,4809,0.52,1569,2180,0.72,791,2692,3483,1835,564,425,1137,1591
"Dallas Mavericks",2010,55,27,8364,102,8141,1,82,19880,3140,6760,0.464,558,1498,0.372,2582,5262,0.491,1526,1870,0.816,834,2586,3420,1917,624,449,1059,1563
"Denver Nuggets",2010,53,29,8729,106.5,8394,1,82,19780,3124,6678,0.468,544,1517,0.359,2580,5161,0.5,1937,2508,0.772,889,2505,3394,1719,683,417,1136,1844
"Detroit Pistons",2010,27,55,7709,94,8128,0,82,19780,2940,6602,0.445,374,1190,0.314,2566,5412,0.474,1455,1998,0.728,1053,2242,3295,1591,596,313,1100,1822
"Golden State Warriors",2010,26,56,8922,108.8,9217,0,82,19730,3329,7094,0.469,633,1687,0.375,2696,5407,0.499,1631,2085,0.782,753,2397,3150,1839,761,340,1204,1886
"Houston Rockets",2010,42,40,8395,102.4,8425,0,82,19905,3094,6923,0.447,646,1838,0.351,2448,5085,0.481,1561,2022,0.772,971,2471,3442,1790,583,318,1188,1712
"Indiana Pacers",2010,32,50,8263,100.8,8510,0,82,19705,3020,6823,0.443,659,1896,0.348,2361,4927,0.479,1564,2019,0.775,785,2618,3403,1730,585,439,1232,1848
"Los Angeles Clippers",2010,29,53,7849,95.7,8370,0,82,19705,3002,6601,0.455,483,1457,0.332,2519,5144,0.49,1362,1867,0.73,927,2502,3429,1810,532,466,1285,1581
"Los Angeles Lakers",2010,57,25,8339,101.7,7952,1,82,19830,3144,6875,0.457,532,1562,0.341,2612,5313,0.492,1519,1985,0.765,973,2662,3635,1730,612,400,1096,1592
"Memphis Grizzlies",2010,40,42,8404,102.5,8528,0,82,19905,3223,6875,0.469,344,1020,0.337,2879,5855,0.492,1614,2202,0.733,1070,2496,3566,1543,645,399,1248,1655
"Miami Heat",2010,47,35,7914,96.5,7727,1,82,19880,2984,6518,0.458,494,1426,0.346,2490,5092,0.489,1452,1931,0.752,875,2553,3428,1548,605,457,1079,1710
"Milwaukee Bucks",2010,46,36,8009,97.7,7870,1,82,19980,3050,6998,0.436,645,1813,0.356,2405,5185,0.464,1264,1675,0.755,965,2560,3525,1740,580,385,1085,1823
"Minnesota Timberwolves",2010,15,67,8051,98.2,8838,0,82,19780,3106,6923,0.449,403,1181,0.341,2703,5742,0.471,1436,1926,0.746,962,2556,3518,1626,597,306,1333,1699
"New Jersey Nets",2010,12,70,7575,92.4,8323,0,82,19780,2813,6554,0.429,377,1185,0.318,2436,5369,0.454,1572,2015,0.78,897,2358,3255,1540,573,393,1182,1643
"New Orleans Hornets",2010,37,45,8220,100.2,8422,0,82,19830,3178,6842,0.464,571,1572,0.363,2607,5270,0.495,1293,1661,0.778,852,2450,3302,1828,625,300,1103,1606
"New York Knicks",2010,29,53,8373,102.1,8686,0,82,19880,3127,6876,0.455,743,2145,0.346,2384,4731,0.504,1376,1759,0.782,836,2477,3313,1772,586,305,1148,1638
"Oklahoma City Thunder",2010,50,32,8322,101.5,8036,1,82,19805,3063,6629,0.462,418,1229,0.34,2645,5400,0.49,1778,2210,0.805,960,2607,3567,1639,654,481,1227,1743
"Orlando Magic",2010,59,23,8426,102.8,7812,1,82,19730,3005,6394,0.47,841,2241,0.375,2164,4153,0.521,1575,2176,0.724,810,2736,3546,1615,512,456,1155,1629
"Philadelphia 76ers",2010,27,55,8014,97.7,8334,0,82,19805,3087,6706,0.46,474,1381,0.343,2613,5325,0.491,1366,1808,0.756,941,2421,3362,1723,667,439,1192,1677
"Phoenix Suns",2010,54,28,9039,110.2,8637,1,82,19730,3339,6788,0.492,730,1770,0.412,2609,5018,0.52,1631,2117,0.77,910,2616,3526,1912,479,418,1210,1713
"Portland Trail Blazers",2010,50,32,8045,98.1,7774,1,82,19855,2974,6453,0.461,491,1388,0.354,2483,5065,0.49,1606,2033,0.79,913,2383,3296,1674,523,350,1012,1715
"Sacramento Kings",2010,25,57,8200,100,8558,0,82,19880,3144,6895,0.456,482,1383,0.349,2662,5512,0.483,1430,1969,0.726,977,2518,3495,1679,564,366,1226,1827
"San Antonio Spurs",2010,50,32,8312,101.4,7895,1,82,19780,3150,6659,0.473,554,1547,0.358,2596,5112,0.508,1458,1969,0.74,887,2621,3508,1829,516,381,1116,1669
"Toronto Raptors",2010,40,42,8534,104.1,8680,0,82,19780,3199,6631,0.482,518,1397,0.371,2681,5234,0.512,1618,2118,0.764,806,2507,3313,1804,469,384,1100,1819
"Utah Jazz",2010,53,29,8547,104.2,8109,1,82,19755,3227,6575,0.491,439,1207,0.364,2788,5368,0.519,1654,2233,0.741,872,2588,3460,2187,675,400,1246,1859
"Washington Wizards",2010,26,56,7892,96.2,8284,0,82,19830,3008,6700,0.449,432,1225,0.353,2576,5475,0.471,1444,1895,0.762,966,2458,3424,1557,493,421,1219,1752
"Atlanta Hawks",2011,62,20,7790,95,7857,1,82,19730,2971,6429,0.462,502,1427,0.352,2469,5002,0.494,1346,1728,0.779,762,2460,3222,1802,497,341,1118,1554
"Boston Celtics",2011,61,21,7913,96.5,7473,1,82,19780,3023,6219,0.486,408,1119,0.365,2615,5100,0.513,1459,1895,0.77,639,2542,3181,1921,676,344,1195,1678
"Charlotte Bobcats",2011,58,24,7650,93.3,7978,0,82,19805,2873,6365,0.451,393,1203,0.327,2480,5162,0.48,1511,1999,0.756,848,2444,3292,1728,524,433,1192,1637
"Chicago Bulls",2011,57,25,8087,98.6,7487,1,82,19830,3042,6587,0.462,511,1415,0.361,2531,5172,0.489,1492,2008,0.743,967,2654,3621,1827,592,468,1161,1639
"Cleveland Cavaliers",2011,57,25,7827,95.5,8566,0,82,19755,2886,6647,0.434,509,1489,0.342,2377,5158,0.461,1546,2075,0.745,856,2449,3305,1720,544,341,1166,1648
"Dallas Mavericks",2011,56,26,8220,100.2,7873,1,82,19705,3069,6463,0.475,645,1768,0.365,2424,4695,0.516,1437,1850,0.777,780,2618,3398,1954,557,352,1145,1575
"Denver Nuggets",2011,55,27,8811,107.5,8421,1,82,19705,3145,6613,0.476,662,1704,0.388,2483,4909,0.506,1859,2429,0.765,791,2652,3443,1813,605,352,1157,1719
"Detroit Pistons",2011,52,30,7951,97,8246,0,82,19880,3056,6647,0.46,472,1256,0.376,2584,5391,0.479,1367,1854,0.737,931,2236,3167,1730,595,328,1067,1629
"Golden State Warriors",2011,50,32,8477,103.4,8668,0,82,19830,3251,7047,0.461,685,1749,0.392,2566,5298,0.484,1290,1695,0.761,955,2370,3325,1847,737,406,1198,1806
"Houston Rockets",2011,48,34,8685,105.9,8506,0,82,19880,3170,6975,0.454,677,1843,0.367,2493,5132,0.486,1668,2083,0.801,962,2549,3511,1955,581,371,1110,1641
"Indiana Pacers",2011,46,36,8183,99.8,8271,1,82,19780,3003,6787,0.442,585,1653,0.354,2418,5134,0.471,1592,2035,0.782,914,2657,3571,1611,584,456,1262,1782
"Los Angeles Clippers",2011,46,36,8089,98.6,8346,0,82,19855,3015,6594,0.457,513,1519,0.338,2502,5075,0.493,1546,2187,0.707,955,2501,3456,1813,585,402,1343,1733
"Los Angeles Lakers",2011,44,38,8321,101.5,7820,1,82,19830,3128,6757,0.463,524,1487,0.352,2604,5270,0.494,1541,1979,0.779,989,2616,3605,1801,602,422,1073,1555
"Memphis Grizzlies",2011,43,39,8195,99.9,8003,1,82,19880,3200,6801,0.471,309,926,0.334,2891,5875,0.492,1486,1981,0.75,970,2391,3361,1691,771,441,1145,1705
"Miami Heat",2011,42,40,8369,102.1,7757,1,82,19780,3031,6301,0.481,547,1479,0.37,2484,4822,0.515,1760,2288,0.769,790,2666,3456,1639,544,430,1142,1674
"Milwaukee Bucks",2011,41,41,7534,91.9,7603,0,82,19830,2814,6544,0.43,483,1414,0.342,2331,5130,0.454,1423,1881,0.757,862,2480,3342,1545,617,399,1103,1682
"Minnesota Timberwolves",2011,40,42,8288,101.1,8832,0,82,19780,3090,7014,0.441,589,1565,0.376,2501,5449,0.459,1519,1977,0.768,1085,2556,3641,1650,592,422,1398,1825
"New Jersey Nets",2011,39,43,7722,94.2,8234,0,82,20005,2918,6638,0.44,459,1337,0.343,2459,5301,0.464,1427,1881,0.759,909,2440,3349,1723,458,384,1152,1807
"New Orleans Hornets",2011,37,45,7784,94.9,7711,1,82,19830,2944,6416,0.459,444,1232,0.36,2500,5184,0.482,1452,1897,0.765,824,2468,3292,1691,624,359,1069,1719
"New York Knicks",2011,36,46,8734,106.5,8670,1,82,19780,3140,6867,0.457,765,2081,0.368,2375,4786,0.496,1689,2087,0.809,847,2470,3317,1757,625,475,1123,1743
"Oklahoma City Thunder",2011,35,47,8596,104.8,8285,1,82,20005,3066,6609,0.464,487,1403,0.347,2579,5206,0.495,1977,2401,0.823,903,2604,3507,1672,654,487,1156,1836
"Orlando Magic",2011,34,48,8135,99.2,7687,1,82,19830,2956,6411,0.461,770,2103,0.366,2186,4308,0.507,1453,2101,0.692,864,2679,3543,1636,548,384,1224,1640
"Philadelphia 76ers",2011,32,50,8119,99,7996,1,82,19930,3125,6776,0.461,443,1248,0.355,2682,5528,0.485,1426,1851,0.77,850,2578,3428,1861,621,355,1063,1592
"Phoenix Suns",2011,30,52,8611,105,8684,0,82,20005,3219,6844,0.47,701,1857,0.377,2518,4987,0.505,1472,1939,0.759,821,2478,3299,1945,545,357,1169,1666
"Portland Trail Blazers",2011,24,58,7896,96.3,7771,1,82,19805,2951,6599,0.447,518,1503,0.345,2433,5096,0.477,1476,1835,0.804,996,2230,3226,1736,660,358,1070,1585
"Sacramento Kings",2011,24,58,8151,99.4,8589,0,82,19855,3134,6979,0.449,428,1277,0.335,2706,5702,0.475,1455,1981,0.734,1071,2526,3597,1675,608,391,1324,1805
"San Antonio Spurs",2011,23,59,8502,103.7,8034,1,82,19780,3148,6628,0.475,685,1727,0.397,2463,4901,0.503,1521,1984,0.767,829,2603,3432,1836,602,372,1101,1556
"Toronto Raptors",2011,22,60,8124,99.1,8639,0,82,19780,3144,6755,0.465,345,1091,0.316,2799,5664,0.494,1491,1976,0.755,963,2343,3306,1795,581,350,1206,1807
"Utah Jazz",2011,19,63,8153,99.4,8303,0,82,19880,3064,6590,0.465,435,1256,0.346,2629,5334,0.493,1590,2061,0.771,898,2338,3236,1921,629,484,1175,1865
"Washington Wizards",2011,17,65,7977,97.3,8584,0,82,19930,3048,6888,0.443,392,1182,0.332,2656,5706,0.465,1489,1999,0.745,1013,2374,3387,1592,665,502,1258,1850
"Atlanta Hawks",2012,40,26,6375,96.6,6148,1,66,16165,2429,5348,0.454,492,1330,0.37,1937,4018,0.482,1025,1385,0.74,652,2066,2718,1481,536,303,921,1178
"Boston Celtics",2012,39,27,6062,91.8,5896,1,66,15940,2341,5086,0.46,363,988,0.367,1978,4098,0.483,1017,1308,0.778,509,2051,2560,1557,498,362,979,1315
"Charlotte Bobcats",2012,7,59,5739,87,6657,0,66,15890,2193,5293,0.414,263,892,0.295,1930,4401,0.439,1090,1462,0.746,677,1894,2571,1326,397,361,957,1249
"Chicago Bulls",2012,50,16,6359,96.3,5819,1,66,15940,2467,5462,0.452,419,1117,0.375,2048,4345,0.471,1006,1394,0.722,915,2165,3080,1527,456,388,923,1139
"Cleveland Cavaliers",2012,21,45,6140,93,6615,0,66,15965,2261,5360,0.422,440,1273,0.346,1821,4087,0.446,1178,1645,0.716,841,1949,2790,1308,466,262,1017,1317
"Dallas Mavericks",2012,36,30,6322,95.8,6259,1,66,16065,2398,5412,0.443,497,1464,0.339,1901,3948,0.482,1029,1334,0.771,665,2157,2822,1380,565,337,926,1226
"Denver Nuggets",2012,38,28,6872,104.1,6682,1,66,16040,2572,5404,0.476,435,1311,0.332,2137,4093,0.522,1293,1760,0.735,738,2105,2843,1581,540,330,1015,1297
"Detroit Pistons",2012,25,41,5997,90.9,6313,0,66,15965,2291,5232,0.438,317,916,0.346,1974,4316,0.457,1098,1461,0.752,775,1882,2657,1232,460,278,1033,1293
"Golden State Warriors",2012,23,43,6453,97.8,6678,0,66,15915,2489,5443,0.457,524,1351,0.388,1965,4092,0.48,951,1235,0.77,640,1947,2587,1470,528,362,915,1410
"Houston Rockets",2012,34,32,6474,98.1,6459,0,66,16065,2489,5543,0.449,478,1330,0.359,2011,4213,0.477,1018,1301,0.782,769,2014,2783,1404,496,319,955,1347
"Indiana Pacers",2012,42,24,6449,97.7,6231,1,66,15990,2354,5375,0.438,392,1064,0.368,1962,4311,0.455,1349,1724,0.782,826,2070,2896,1228,523,357,925,1430
"Los Angeles Clippers",2012,40,26,6438,97.5,6269,1,66,15965,2439,5366,0.455,514,1441,0.357,1925,3925,0.49,1046,1538,0.68,800,1943,2743,1385,556,315,879,1399
"Los Angeles Lakers",2012,41,25,6422,97.3,6328,1,66,16065,2429,5319,0.457,362,1112,0.326,2067,4207,0.491,1202,1589,0.756,799,2251,3050,1485,390,351,997,1109
"Memphis Grizzlies",2012,41,25,6269,95,6136,1,66,15940,2425,5422,0.447,277,849,0.326,2148,4573,0.47,1142,1504,0.759,831,1944,2775,1290,631,345,955,1316
"Miami Heat",2012,46,20,6500,98.5,6105,1,66,16040,2446,5212,0.469,370,1030,0.359,2076,4182,0.496,1238,1598,0.775,686,2060,2746,1317,585,355,1002,1282
"Milwaukee Bucks",2012,31,35,6535,99,6517,0,66,15865,2502,5652,0.443,436,1265,0.345,2066,4387,0.471,1095,1415,0.774,820,1983,2803,1550,548,335,929,1273
"Minnesota Timberwolves",2012,26,40,6464,97.9,6609,0,66,15940,2355,5434,0.433,473,1423,0.332,1882,4011,0.469,1281,1662,0.771,797,2089,2886,1290,436,293,1001,1212
"New Jersey Nets",2012,22,44,6144,93.1,6539,0,66,15890,2262,5320,0.425,507,1481,0.342,1755,3839,0.457,1113,1433,0.777,783,1879,2662,1311,493,260,995,1268
"New Orleans Hornets",2012,21,45,5916,89.6,6164,0,66,15940,2300,5103,0.451,259,777,0.333,2041,4326,0.472,1057,1397,0.757,724,1991,2715,1368,488,316,1024,1324
"New York Knicks",2012,36,30,6458,97.8,6247,1,66,15940,2365,5335,0.443,517,1538,0.336,1848,3797,0.487,1211,1634,0.741,743,2012,2755,1328,622,276,1056,1391
"Oklahoma City Thunder",2012,47,19,6802,103.1,6398,1,66,15990,2462,5229,0.471,472,1317,0.358,1990,3912,0.509,1406,1744,0.806,726,2157,2883,1224,498,539,1079,1352
"Orlando Magic",2012,37,29,6215,94.2,6163,1,66,15965,2275,5162,0.441,670,1785,0.375,1605,3377,0.475,995,1508,0.66,742,2060,2802,1321,451,275,984,1168
"Philadelphia 76ers",2012,35,31,6180,93.6,5900,1,66,15915,2471,5516,0.448,349,963,0.362,2122,4553,0.466,889,1198,0.742,704,2144,2848,1453,526,340,738,1157
"Phoenix Suns",2012,33,33,6492,98.4,6508,0,66,15840,2495,5445,0.458,444,1295,0.343,2051,4150,0.494,1058,1397,0.757,717,2035,2752,1486,431,366,928,1233
"Portland Trail Blazers",2012,28,38,6415,97.2,6456,0,66,15965,2402,5417,0.443,478,1382,0.346,1924,4035,0.477,1133,1423,0.796,735,1949,2684,1349,528,322,935,1251
"Sacramento Kings",2012,22,44,6518,98.8,6893,0,66,15915,2490,5712,0.436,411,1301,0.316,2079,4411,0.471,1127,1532,0.736,882,1947,2829,1271,561,323,952,1287
"San Antonio Spurs",2012,50,16,6841,103.7,6368,1,66,15940,2611,5463,0.478,552,1405,0.393,2059,4058,0.507,1067,1427,0.748,683,2153,2836,1528,490,293,895,1143
"Toronto Raptors",2012,23,43,5986,90.7,6204,0,66,15965,2268,5154,0.44,365,1075,0.34,1903,4079,0.467,1085,1410,0.77,697,2074,2771,1382,429,321,1001,1532
"Utah Jazz",2012,36,30,6577,99.7,6536,1,66,16165,2523,5531,0.456,273,845,0.323,2250,4686,0.48,1258,1668,0.754,861,2055,2916,1439,545,385,936,1441
"Washington Wizards",2012,20,46,6180,93.6,6497,0,66,15865,2414,5475,0.441,344,1075,0.32,2070,4400,0.47,1008,1386,0.727,775,1975,2750,1262,527,417,1008,1405
"Atlanta Hawks",2013,44,38,8032,98,7999,1,82,19855,3084,6644,0.464,706,1901,0.371,2378,4743,0.501,1158,1619,0.715,758,2593,3351,2007,664,369,1219,1473
"Boston Celtics",2013,41,40,7818,96.5,7836,1,81,19840,3001,6459,0.465,498,1390,0.358,2503,5069,0.494,1318,1698,0.776,654,2533,3187,1843,667,365,1181,1717
"Brooklyn Nets",2013,49,33,7944,96.9,7798,1,82,19855,2942,6544,0.45,628,1760,0.357,2314,4784,0.484,1432,1958,0.731,1047,2460,3507,1668,599,391,1206,1500
"Charlotte Bobcats",2013,21,61,7661,93.4,8418,0,82,19805,2823,6649,0.425,469,1399,0.335,2354,5250,0.448,1546,2060,0.75,917,2389,3306,1587,591,479,1153,1561
"Chicago Bulls",2013,45,37,7641,93.2,7615,1,82,19830,2926,6698,0.437,446,1265,0.353,2480,5433,0.456,1343,1738,0.773,1026,2514,3540,1886,588,417,1171,1617
"Cleveland Cavaliers",2013,24,58,7913,96.5,8297,0,82,19730,2993,6901,0.434,547,1581,0.346,2446,5320,0.46,1380,1826,0.756,1004,2359,3363,1694,647,334,1149,1737
"Dallas Mavericks",2013,41,41,8293,101.1,8342,0,82,19980,3182,6892,0.462,606,1628,0.372,2576,5264,0.489,1323,1669,0.793,767,2670,3437,1906,648,454,1144,1698
"Denver Nuggets",2013,57,25,8704,106.1,8287,1,82,19905,3339,6983,0.478,521,1518,0.343,2818,5465,0.516,1505,2148,0.701,1092,2601,3693,2002,762,533,1253,1682
"Detroit Pistons",2013,29,53,7778,94.9,8105,0,82,19805,2979,6638,0.449,513,1440,0.356,2466,5198,0.474,1307,1870,0.699,991,2463,3454,1742,574,400,1241,1623
"Golden State Warriors",2013,47,35,8296,101.2,8223,1,82,19805,3130,6840,0.458,658,1632,0.403,2472,5208,0.475,1378,1744,0.79,885,2801,3686,1845,567,346,1236,1753
"Houston Rockets",2013,45,37,8688,106,8403,1,82,19780,3124,6782,0.461,867,2369,0.366,2257,4413,0.511,1573,2087,0.754,909,2652,3561,1902,679,359,1348,1662
"Indiana Pacers",2013,49,32,7674,94.7,7348,1,81,19590,2845,6525,0.436,555,1599,0.347,2290,4926,0.465,1429,1915,0.746,1043,2671,3714,1645,580,513,1227,1623
"Los Angeles Clippers",2013,56,26,8289,101.1,7760,1,82,19730,3160,6608,0.478,627,1752,0.358,2533,4856,0.522,1342,1888,0.711,938,2475,3413,1958,784,461,1197,1716
"Los Angeles Lakers",2013,45,37,8381,102.2,8286,1,82,19755,3041,6640,0.458,715,2015,0.355,2326,4625,0.503,1584,2289,0.692,942,2732,3674,1818,576,429,1232,1467
"Memphis Grizzlies",2013,56,26,7659,93.4,7319,1,82,19805,2964,6679,0.444,382,1107,0.345,2582,5572,0.463,1349,1746,0.773,1059,2445,3504,1715,703,436,1144,1660
"Miami Heat",2013,66,16,8436,102.9,7791,1,82,19880,3148,6348,0.496,717,1809,0.396,2431,4539,0.536,1423,1887,0.754,676,2490,3166,1890,710,441,1143,1533
"Milwaukee Bucks",2013,38,44,8108,98.9,8231,1,82,19830,3128,7197,0.435,601,1670,0.36,2527,5527,0.457,1251,1700,0.736,1068,2537,3605,1876,685,550,1156,1554
"Minnesota Timberwolves",2013,31,51,7851,95.7,8045,0,82,19730,2943,6702,0.439,450,1475,0.305,2493,5227,0.477,1515,2042,0.742,973,2473,3446,1836,700,387,1214,1509
"New Orleans Hornets",2013,27,55,7714,94.1,8031,0,82,19780,2955,6589,0.448,535,1474,0.363,2420,5115,0.473,1269,1636,0.776,988,2426,3414,1721,520,440,1193,1673
"New York Knicks",2013,54,28,8196,100,7849,1,82,19730,2996,6689,0.448,891,2371,0.376,2105,4318,0.487,1313,1729,0.759,890,2436,3326,1579,672,294,988,1650
"Oklahoma City Thunder",2013,60,22,8669,105.7,7914,1,82,19830,3126,6504,0.481,598,1588,0.377,2528,4916,0.514,1819,2196,0.828,854,2725,3579,1753,679,624,1253,1654
"Orlando Magic",2013,20,62,7718,94.1,8291,0,82,19780,3093,6904,0.448,506,1537,0.329,2587,5367,0.482,1026,1359,0.755,890,2612,3502,1871,528,358,1191,1591
"Philadelphia 76ers",2013,34,48,7640,93.2,7914,0,82,19755,3059,6895,0.444,518,1438,0.36,2541,5457,0.466,1004,1377,0.729,896,2493,3389,1867,609,384,1070,1505
"Phoenix Suns",2013,25,57,7805,95.2,8335,0,82,19805,3061,6917,0.443,480,1455,0.33,2581,5462,0.473,1203,1618,0.744,959,2454,3413,1855,659,434,1278,1688
"Portland Trail Blazers",2013,33,49,7995,97.5,8255,0,82,19855,3009,6715,0.448,673,1904,0.353,2336,4811,0.486,1304,1680,0.776,874,2474,3348,1784,538,353,1203,1518
"Sacramento Kings",2013,28,54,8219,100.2,8619,0,82,19830,3086,6904,0.447,610,1681,0.363,2476,5223,0.474,1437,1869,0.769,943,2385,3328,1708,671,342,1199,1717
"San Antonio Spurs",2013,58,24,8448,103,7923,1,82,19880,3210,6675,0.481,663,1764,0.376,2547,4911,0.519,1365,1725,0.791,666,2721,3387,2058,695,446,1206,1427
"Toronto Raptors",2013,34,48,7971,97.2,8092,0,82,19980,2979,6685,0.446,571,1665,0.343,2408,5020,0.48,1442,1831,0.788,871,2426,3297,1765,595,392,1124,1836
"Utah Jazz",2013,43,39,8038,98,8045,0,82,19880,3046,6710,0.454,507,1385,0.366,2539,5325,0.477,1439,1883,0.764,989,2457,3446,1859,690,515,1210,1750
"Washington Wizards",2013,29,53,7644,93.2,7852,0,82,19855,2910,6693,0.435,545,1495,0.365,2365,5198,0.455,1279,1746,0.733,887,2652,3539,1775,598,376,1238,1681
"Atlanta Hawks",2014,38,44,8282,101,8321,1,82,19830,3061,6688,0.458,768,2116,0.363,2293,4572,0.502,1392,1782,0.781,713,2565,3278,2041,680,326,1251,1577
"Boston Celtics",2014,25,57,7892,96.2,8258,0,82,19730,2996,6883,0.435,575,1729,0.333,2421,5154,0.47,1325,1706,0.777,980,2505,3485,1726,584,343,1261,1743
"Brooklyn Nets",2014,44,38,8079,98.5,8161,1,82,19880,2931,6391,0.459,709,1922,0.369,2222,4469,0.497,1508,2002,0.753,721,2407,3128,1714,705,311,1191,1777
"Charlotte Bobcats",2014,43,39,7942,96.9,7960,1,82,19905,2976,6730,0.442,516,1471,0.351,2460,5259,0.468,1474,2000,0.737,776,2724,3500,1778,499,421,1010,1493
"Chicago Bulls",2014,48,34,7680,93.7,7528,1,82,19930,2843,6577,0.432,508,1459,0.348,2335,5118,0.456,1486,1908,0.779,937,2683,3620,1860,594,424,1223,1565
"Cleveland Cavaliers",2014,33,49,8054,98.2,8324,0,82,19930,3036,6955,0.437,584,1640,0.356,2452,5315,0.461,1398,1861,0.751,989,2629,3618,1738,579,304,1163,1640
"Dallas Mavericks",2014,49,33,8597,104.8,8400,1,82,19830,3249,6858,0.474,721,1877,0.384,2528,4981,0.508,1378,1733,0.795,840,2514,3354,1935,704,356,1110,1636
"Denver Nuggets",2014,36,46,8559,104.4,8735,0,82,19755,3147,7042,0.447,702,1959,0.358,2445,5083,0.481,1563,2154,0.726,1009,2717,3726,1838,615,459,1305,1890
"Detroit Pistons",2014,29,53,8286,101,8586,0,82,19780,3182,7124,0.447,507,1580,0.321,2675,5544,0.483,1415,2111,0.67,1196,2525,3721,1714,687,395,1193,1666
"Golden State Warriors",2014,51,31,8549,104.3,8155,1,82,19830,3236,7005,0.462,774,2037,0.38,2462,4968,0.496,1303,1731,0.753,896,2819,3715,1912,642,407,1247,1784
"Houston Rockets",2014,54,28,8829,107.7,8455,1,82,19830,3118,6603,0.472,779,2179,0.358,2339,4424,0.529,1814,2549,0.712,920,2797,3717,1755,621,461,1323,1676
"Indiana Pacers",2014,56,26,7933,96.7,7572,1,82,19780,2949,6573,0.449,550,1542,0.357,2399,5031,0.477,1485,1907,0.779,834,2831,3665,1651,550,446,1237,1675
"Los Angeles Clippers",2014,57,25,8850,107.9,8278,1,82,19755,3208,6761,0.474,693,1966,0.352,2515,4795,0.525,1741,2384,0.73,858,2668,3526,2016,703,397,1136,1767
"Los Angeles Lakers",2014,27,55,8442,103,8958,0,82,19705,3139,6980,0.45,774,2032,0.381,2365,4948,0.478,1390,1835,0.757,745,2620,3365,2006,611,446,1239,1627
"Memphis Grizzlies",2014,50,32,7884,96.1,7755,1,82,19805,3122,6723,0.464,405,1147,0.353,2717,5576,0.487,1235,1666,0.741,950,2526,3476,1792,631,375,1124,1568
"Miami Heat",2014,54,28,8380,102.2,7990,1,82,19880,3142,6272,0.501,665,1829,0.364,2477,4443,0.558,1431,1884,0.76,627,2397,3024,1847,732,367,1212,1596
"Milwaukee Bucks",2014,15,67,7829,95.5,8500,0,82,19880,2952,6737,0.438,548,1553,0.353,2404,5184,0.464,1377,1843,0.747,971,2399,3370,1760,541,403,1238,1713
"Minnesota Timberwolves",2014,40,42,8768,106.9,8549,0,82,19855,3189,7175,0.444,600,1757,0.341,2589,5418,0.478,1790,2301,0.778,1024,2644,3668,1963,718,297,1142,1504
"New Orleans Pelicans",2014,34,48,8177,99.7,8399,0,82,19855,3101,6761,0.459,486,1303,0.373,2615,5458,0.479,1489,1936,0.769,933,2486,3419,1745,647,523,1129,1857
"New York Knicks",2014,37,45,8084,98.6,8149,0,82,19855,3027,6739,0.449,759,2038,0.372,2268,4701,0.482,1271,1670,0.761,870,2437,3307,1641,631,367,1063,1815
"Oklahoma City Thunder",2014,59,23,8705,106.2,8185,1,82,19805,3194,6782,0.471,664,1839,0.361,2530,4943,0.512,1653,2052,0.806,887,2781,3668,1794,678,501,1256,1858
"Orlando Magic",2014,23,59,7914,96.5,8360,0,82,19955,3022,6784,0.445,563,1596,0.353,2459,5188,0.474,1307,1714,0.763,794,2654,3448,1726,630,350,1222,1678
"Philadelphia 76ers",2014,19,63,8155,99.5,9012,0,82,19855,3108,7150,0.435,577,1847,0.312,2531,5303,0.477,1362,1918,0.71,949,2556,3505,1791,765,330,1384,1844
"Phoenix Suns",2014,48,34,8629,105.2,8413,0,82,19755,3172,6845,0.463,765,2055,0.372,2407,4790,0.503,1520,2004,0.758,928,2601,3529,1563,688,374,1258,1798
"Portland Trail Blazers",2014,54,28,8753,106.7,8426,1,82,19855,3207,7134,0.45,770,2071,0.372,2437,5063,0.481,1569,1926,0.815,1022,2786,3808,1904,454,387,1125,1576
"Sacramento Kings",2014,28,54,8241,100.5,8479,0,82,19830,3026,6766,0.447,491,1475,0.333,2535,5291,0.479,1698,2237,0.759,990,2656,3646,1547,587,318,1249,1849
"San Antonio Spurs",2014,62,20,8639,105.4,8006,1,82,19755,3326,6844,0.486,698,1757,0.397,2628,5087,0.517,1289,1642,0.785,762,2786,3548,2064,604,420,1180,1495
"Toronto Raptors",2014,48,34,8305,101.3,8039,1,82,19955,2992,6718,0.445,713,1917,0.372,2279,4801,0.475,1608,2055,0.782,935,2552,3487,1737,577,343,1159,1882
"Utah Jazz",2014,25,57,7791,95,8379,0,82,19780,2951,6652,0.444,543,1577,0.344,2408,5075,0.474,1346,1803,0.747,904,2477,3381,1664,570,366,1200,1699
"Washington Wizards",2014,44,38,8254,100.7,8150,1,82,20055,3177,6920,0.459,647,1704,0.38,2530,5216,0.485,1253,1715,0.731,886,2573,3459,1909,668,377,1204,1675
"Atlanta Hawks",2015,60,22,8409,102.5,7964,1,82,19730,3121,6699,0.466,818,2152,0.38,2303,4547,0.506,1349,1735,0.778,715,2611,3326,2111,744,380,1167,1457
"Boston Celtics",2015,40,42,8312,101.4,8299,1,82,19880,3193,7211,0.443,660,2021,0.327,2533,5190,0.488,1266,1678,0.754,910,2685,3595,2009,674,294,1133,1738
"Brooklyn Nets",2015,38,44,8038,98,8274,1,82,19930,3069,6804,0.451,541,1633,0.331,2528,5171,0.489,1359,1817,0.748,846,2627,3473,1716,576,340,1133,1579
"Charlotte Hornets",2015,33,49,7721,94.2,7981,0,82,19905,2913,6932,0.42,498,1566,0.318,2415,5366,0.45,1397,1867,0.748,820,2793,3613,1654,499,448,976,1494
"Chicago Bulls",2015,50,32,8265,100.8,8019,1,82,19880,3001,6797,0.442,645,1825,0.353,2356,4972,0.474,1618,2067,0.783,959,2792,3751,1781,514,476,1145,1495
"Cleveland Cavaliers",2015,53,29,8457,103.1,8090,1,82,19780,3089,6739,0.458,826,2253,0.367,2263,4486,0.504,1453,1934,0.751,911,2612,3523,1814,603,340,1171,1510
"Dallas Mavericks",2015,50,32,8628,105.2,8390,1,82,19880,3255,7036,0.463,732,2082,0.352,2523,4954,0.509,1386,1843,0.752,858,2608,3466,1846,663,371,1062,1644
"Denver Nuggets",2015,30,52,8320,101.5,8611,0,82,19880,3099,7158,0.433,660,2032,0.325,2439,5126,0.476,1462,1991,0.734,1012,2653,3665,1788,641,367,1166,1882
"Detroit Pistons",2015,32,50,8077,98.5,8159,0,82,19830,3041,7038,0.432,703,2043,0.344,2338,4995,0.468,1292,1838,0.703,1051,2630,3681,1771,623,383,1099,1559
"Golden State Warriors",2015,67,15,9016,110,8188,1,82,19730,3410,7137,0.478,883,2217,0.398,2527,4920,0.514,1313,1709,0.768,853,2814,3667,2248,762,496,1185,1628
"Houston Rockets",2015,56,26,8522,103.9,8240,1,82,19805,3032,6832,0.444,933,2680,0.348,2099,4152,0.506,1525,2133,0.715,958,2624,3582,1820,777,407,1366,1803
"Indiana Pacers",2015,38,44,7981,97.3,7958,0,82,19855,2998,6824,0.439,612,1740,0.352,2386,5084,0.469,1373,1817,0.756,856,2822,3678,1757,505,375,1147,1742
"Los Angeles Clippers",2015,56,26,8751,106.7,8211,1,82,19730,3228,6830,0.473,827,2202,0.376,2401,4628,0.519,1468,2067,0.71,784,2711,3495,2031,640,409,1012,1749
"Los Angeles Lakers",2015,21,61,8073,98.5,8634,0,82,19930,3054,7020,0.435,532,1546,0.344,2522,5474,0.461,1433,1935,0.741,952,2647,3599,1715,578,366,1086,1741
"Memphis Grizzlies",2015,55,27,8062,98.3,7796,1,82,19905,3097,6763,0.458,423,1246,0.339,2674,5517,0.485,1445,1869,0.773,856,2634,3490,1777,700,347,1094,1567
"Miami Heat",2015,37,45,7764,94.7,7977,0,82,19730,2885,6330,0.456,556,1659,0.335,2329,4671,0.499,1438,1940,0.741,747,2461,3208,1626,642,372,1214,1636
"Milwaukee Bucks",2015,41,41,8023,97.8,7988,1,82,19930,3083,6722,0.459,545,1500,0.363,2538,5222,0.486,1312,1734,0.757,876,2574,3450,1932,789,403,1373,1814
"Minnesota Timberwolves",2015,16,66,8016,97.8,8737,0,82,19805,2986,6820,0.438,406,1223,0.332,2580,5597,0.461,1638,2110,0.776,949,2406,3355,1771,668,327,1231,1571
"New Orleans Pelicans",2015,45,37,8147,99.4,8082,1,82,19780,3108,6795,0.457,586,1583,0.37,2522,5212,0.484,1345,1790,0.751,942,2621,3563,1806,553,510,1087,1530
"New York Knicks",2015,17,65,7535,91.9,8299,0,82,19855,2882,6726,0.428,560,1614,0.347,2322,5112,0.454,1211,1575,0.769,867,2443,3310,1746,575,382,1206,1768
"Oklahoma City Thunder",2015,45,37,8524,104,8345,0,82,19830,3184,7119,0.447,632,1864,0.339,2552,5255,0.486,1524,2020,0.754,1052,2844,3896,1681,598,454,1205,1829
"Orlando Magic",2015,25,57,7847,95.7,8316,0,82,19755,3076,6792,0.453,554,1598,0.347,2522,5194,0.486,1141,1565,0.729,822,2607,3429,1692,647,314,1221,1714
"Philadelphia 76ers",2015,18,64,7542,92,8278,0,82,19805,2765,6777,0.408,692,2160,0.32,2073,4617,0.449,1320,1953,0.676,978,2536,3514,1683,789,487,1453,1778
"Phoenix Suns",2015,39,43,8397,102.4,8471,0,82,19880,3178,7038,0.452,698,2048,0.341,2480,4990,0.497,1343,1767,0.76,896,2643,3539,1659,700,385,1238,1744
"Portland Trail Blazers",2015,51,31,8429,102.8,8082,1,82,19855,3175,7049,0.45,807,2231,0.362,2368,4818,0.491,1272,1589,0.801,879,2881,3760,1799,525,372,1117,1494
"Sacramento Kings",2015,29,53,8310,101.3,8614,0,82,19855,3010,6617,0.455,461,1350,0.341,2549,5267,0.484,1829,2400,0.762,895,2728,3623,1667,550,324,1333,1696
"San Antonio Spurs",2015,55,27,8461,103.2,7953,1,82,19955,3208,6854,0.468,677,1847,0.367,2531,5007,0.505,1368,1754,0.78,806,2772,3578,2000,657,444,1146,1564
"Toronto Raptors",2015,49,33,8527,104,8275,1,82,19855,3108,6829,0.455,726,2060,0.352,2382,4769,0.499,1585,2014,0.787,881,2526,3407,1701,615,357,1057,1712
"Utah Jazz",2015,38,44,7801,95.1,7783,0,82,19705,2900,6492,0.447,610,1781,0.343,2290,4711,0.486,1391,1929,0.721,988,2617,3605,1632,623,489,1256,1583
"Washington Wizards",2015,46,36,8080,98.5,8021,1,82,19955,3139,6790,0.462,497,1381,0.36,2642,5409,0.488,1305,1758,0.742,862,2801,3663,1969,601,378,1233,1707
"Atlanta Hawks",2016,48,34,8433,102.8,8137,1,82,19830,3168,6923,0.458,815,2326,0.35,2353,4597,0.512,1282,1638,0.783,679,2772,3451,2100,747,486,1226,1570
"Boston Celtics",2016,48,34,8669,105.7,8406,1,82,19780,3216,7318,0.439,717,2142,0.335,2499,5176,0.483,1520,1929,0.788,950,2733,3683,1981,752,348,1127,1796
"Brooklyn Nets",2016,21,61,8089,98.6,8692,0,82,19755,3136,6920,0.453,531,1508,0.352,2605,5412,0.481,1286,1699,0.757,863,2614,3477,1829,627,332,1212,1476
"Charlotte Hornets",2016,48,34,8479,103.4,8256,1,82,19855,3036,6922,0.439,873,2410,0.362,2163,4512,0.479,1534,1941,0.79,734,2869,3603,1778,595,438,1030,1487
"Chicago Bulls",2016,42,40,8335,101.6,8456,0,82,19905,3165,7170,0.441,651,1753,0.371,2514,5417,0.464,1354,1720,0.787,907,2889,3796,1870,495,470,1141,1545
"Cleveland Cavaliers",2016,57,25,8555,104.3,8063,1,82,19855,3171,6888,0.46,880,2428,0.362,2291,4460,0.514,1333,1783,0.748,873,2777,3650,1861,551,317,1114,1666
"Dallas Mavericks",2016,42,40,8388,102.3,8413,1,82,20005,3064,6900,0.444,806,2342,0.344,2258,4558,0.495,1454,1831,0.794,751,2781,3532,1813,560,306,1047,1595
"Denver Nuggets",2016,33,49,8355,101.9,8609,0,82,19830,3093,7003,0.442,656,1943,0.338,2437,5060,0.482,1513,1974,0.766,941,2718,3659,1858,609,395,1202,1723
"Detroit Pistons",2016,44,38,8361,102,8311,1,82,19880,3111,7087,0.439,740,2148,0.345,2371,4939,0.48,1399,2095,0.668,1021,2777,3798,1594,573,304,1110,1557
"Golden State Warriors",2016,73,9,9421,114.9,8539,1,82,19880,3489,7159,0.487,1077,2592,0.416,2412,4567,0.528,1366,1790,0.763,816,2972,3788,2373,689,498,1245,1701
"Houston Rockets",2016,41,41,8737,106.5,8721,1,82,19830,3094,6847,0.452,878,2533,0.347,2216,4314,0.514,1671,2407,0.694,930,2601,3531,1821,821,430,1307,1790
"Indiana Pacers",2016,45,37,8377,102.2,8237,1,82,19880,3142,6985,0.45,663,1889,0.351,2479,5096,0.486,1430,1872,0.764,847,2779,3626,1741,742,391,1219,1641
"Los Angeles Clippers",2016,53,29,8569,104.5,8218,1,82,19830,3141,6759,0.465,797,2190,0.364,2344,4569,0.513,1490,2152,0.692,721,2727,3448,1873,709,460,1063,1746
"Los Angeles Lakers",2016,17,65,7982,97.3,8766,0,82,19730,2880,6956,0.414,639,2016,0.317,2241,4940,0.454,1583,2028,0.781,878,2645,3523,1478,593,337,1124,1662
"Memphis Grizzlies",2016,42,40,8126,99.1,8310,1,82,19830,3019,6859,0.44,504,1521,0.331,2515,5338,0.471,1584,2024,0.783,916,2497,3413,1697,724,350,1090,1783
"Miami Heat",2016,48,34,8204,100,8069,1,82,19830,3150,6697,0.47,498,1480,0.336,2652,5217,0.508,1406,1889,0.744,807,2811,3618,1709,553,531,1155,1502
"Milwaukee Bucks",2016,33,49,8122,99,8465,0,82,19830,3145,6740,0.467,440,1277,0.345,2705,5463,0.495,1392,1863,0.747,858,2559,3417,1895,672,475,1247,1695
"Minnesota Timberwolves",2016,29,53,8398,102.4,8688,0,82,19880,3095,6668,0.464,455,1347,0.338,2640,5321,0.496,1753,2213,0.792,821,2587,3408,1916,656,375,1231,1696
"New Orleans Pelicans",2016,30,52,8423,102.7,8734,0,82,19780,3153,7040,0.448,702,1951,0.36,2451,5089,0.482,1415,1823,0.776,782,2712,3494,1818,633,342,1102,1713
"New York Knicks",2016,32,50,8065,98.4,8289,0,82,19805,3022,6886,0.439,610,1762,0.346,2412,5124,0.471,1411,1753,0.805,850,2788,3638,1682,467,466,1099,1616
"Oklahoma City Thunder",2016,55,27,9038,110.2,8441,1,82,19830,3372,7082,0.476,678,1945,0.349,2694,5137,0.524,1616,2067,0.782,1071,2916,3987,1883,603,487,1305,1691
"Orlando Magic",2016,35,47,8369,102.1,8502,0,82,19905,3242,7120,0.455,636,1818,0.35,2606,5302,0.492,1249,1649,0.757,843,2709,3552,1933,673,417,1155,1701
"Philadelphia 76ers",2016,10,72,7988,97.4,8827,0,82,19805,2970,6887,0.431,764,2255,0.339,2206,4632,0.476,1284,1850,0.694,777,2605,3382,1765,680,495,1343,1780
"Phoenix Suns",2016,23,59,8271,100.9,8817,0,82,19705,3051,7018,0.435,738,2118,0.348,2313,4900,0.472,1431,1905,0.751,943,2733,3676,1701,632,313,1410,1858
"Portland Trail Blazers",2016,44,38,8622,105.1,8554,1,82,19805,3167,7040,0.45,864,2336,0.37,2303,4704,0.49,1424,1889,0.754,948,2782,3730,1748,562,380,1200,1782
"Sacramento Kings",2016,33,49,8740,106.6,8943,0,82,19805,3283,7083,0.464,660,1839,0.359,2623,5244,0.5,1514,2089,0.725,868,2760,3628,2009,733,368,1326,1676
"San Antonio Spurs",2016,67,15,8490,103.5,7618,1,82,19705,3289,6797,0.484,570,1518,0.375,2719,5279,0.515,1342,1672,0.803,770,2831,3601,2010,677,485,1071,1433
"Toronto Raptors",2016,56,26,8422,102.7,8053,1,82,19780,3006,6669,0.451,708,1915,0.37,2298,4754,0.483,1702,2190,0.777,836,2724,3560,1536,636,449,1073,1610
"Utah Jazz",2016,40,42,8010,97.7,7863,0,82,19955,2957,6593,0.449,694,1956,0.355,2263,4637,0.488,1402,1885,0.744,880,2665,3545,1555,631,425,1224,1655
"Washington Wizards",2016,41,41,8534,104.1,8575,0,82,19755,3238,7033,0.46,709,1983,0.358,2529,5050,0.501,1349,1849,0.73,743,2688,3431,2005,708,323,1186,1708
