Rk,Team,G,MP,FG,FGA,FG_P,3P,3PA,3P_P,2P,2PA,2P_P,FT,FTA,FT_P,ORB,DRB,TRB,AST,STL,BLK,TOV,PF,PTS,PTS/G
1,Atlanta Hawks,82,19905,2829,6529,.433,419,1249,.335,2410,5280,.456,1534,1976,.776,996,2507,3503,1648,627,408,1350,1826,7611,92.8
2,Boston Celtics*,82,19705,2843,6415,.443,553,1599,.346,2290,4816,.475,1572,2095,.750,851,2440,3291,1683,770,331,1332,1837,7811,95.3
3,Chicago Bulls,82,19830,2798,6753,.414,429,1256,.342,2369,5497,.431,1330,1834,.725,1048,2519,3567,1793,659,396,1321,1911,7355,89.7
4,Cleveland Cavaliers,82,19855,2922,6753,.433,247,786,.314,2675,5967,.448,1528,2030,.753,1118,2619,3737,1808,585,537,1216,1743,7619,92.9
5,Dallas Mavericks*,82,19805,3322,7230,.459,507,1456,.348,2815,5774,.488,1475,1854,.796,1174,2538,3712,1963,656,437,1000,1609,8626,105.2
6,Denver Nuggets*,82,19730,2993,6763,.443,331,985,.336,2662,5778,.461,1655,2159,.767,1083,2387,3470,1794,745,520,1278,1804,7972,97.2
7,Detroit Pistons*,82,19780,2747,6314,.435,333,968,.344,2414,5346,.452,1561,2074,.753,1014,2492,3506,1702,659,570,1241,1664,7388,90.1
8,Golden State Warriors,82,19855,2875,6511,.442,429,1283,.334,2446,5228,.468,1470,2028,.725,1002,2533,3535,1681,576,389,1211,1691,7649,93.3
9,Houston Rockets*,82,19930,2738,6195,.442,515,1406,.366,2223,4789,.464,1371,1774,.773,847,2647,3494,1579,560,443,1373,1762,7362,89.8
10,Indiana Pacers*,82,19805,2753,6322,.435,449,1281,.351,2304,5041,.457,1538,2014,.764,965,2452,3417,1774,726,411,1182,1709,7493,91.4
11,Los Angeles Clippers,82,19805,2817,6579,.428,329,1024,.321,2488,5555,.448,1808,2302,.785,1149,2416,3565,1653,594,376,1344,1816,7771,94.8
12,Los Angeles Lakers*,82,19855,3028,6676,.454,365,1115,.327,2663,5561,.479,1631,2352,.693,1001,2535,3536,1948,682,379,1132,1732,8052,98.2
13,Memphis Grizzlies*,82,19880,2963,6657,.445,447,1314,.340,2516,5343,.471,1557,2143,.727,1047,2381,3428,1915,795,565,1226,1903,7930,96.7
14,Miami Heat*,82,19755,2729,6417,.425,485,1357,.357,2244,5060,.443,1459,1915,.762,940,2459,3399,1565,590,313,1137,1812,7402,90.3
15,Milwaukee Bucks*,82,19780,2970,6650,.447,401,1145,.350,2569,5505,.467,1698,2192,.775,960,2502,3462,1872,554,383,1110,1668,8039,98.0
16,Minnesota Timberwolves*,82,19755,3033,6571,.462,326,897,.363,2707,5674,.477,1361,1743,.781,875,2645,3520,1890,561,462,1043,1731,7753,94.5
17,New Jersey Nets*,82,19705,2813,6372,.441,377,1123,.336,2436,5249,.464,1398,1856,.753,862,2473,3335,2009,709,322,1209,1722,7401,90.3
18,New Orleans Hornets*,82,19830,2772,6605,.420,531,1666,.319,2241,4939,.454,1454,1937,.751,1091,2418,3509,1716,708,346,1228,1715,7529,91.8
19,New York Knicks*,82,19880,2881,6513,.442,406,1115,.364,2475,5398,.459,1374,1732,.793,950,2543,3493,1695,608,391,1289,1897,7542,92.0
20,Orlando Magic,82,19830,2904,6768,.429,429,1248,.344,2475,5520,.448,1474,2000,.737,1003,2350,3353,1584,547,308,1123,1744,7711,94.0
21,Philadelphia 76ers,82,19855,2682,6260,.428,339,992,.342,2343,5268,.445,1512,2009,.753,941,2408,3349,1640,654,358,1307,1701,7215,88.0
22,Phoenix Suns,82,19730,2958,6671,.443,415,1202,.345,2543,5469,.465,1392,1865,.746,924,2406,3330,1586,734,383,1249,1862,7723,94.2
23,Portland Trail Blazers,82,19980,2898,6467,.448,381,1102,.346,2517,5365,.469,1263,1728,.731,1040,2376,3416,1768,613,443,1213,1554,7440,90.7
24,Sacramento Kings*,82,19780,3103,6711,.462,601,1498,.401,2502,5213,.480,1626,2044,.795,888,2492,3380,2152,710,325,1137,1586,8433,102.8
25,San Antonio Spurs*,82,19755,2842,6434,.442,408,1140,.358,2434,5294,.460,1409,2069,.681,1029,2669,3698,1676,661,537,1203,1667,7501,91.5
26,Seattle SuperSonics,82,19805,2939,6590,.446,723,1936,.373,2216,4654,.476,1363,1782,.765,907,2318,3225,1782,661,387,1188,1784,7964,97.1
27,Toronto Raptors,82,19980,2654,6348,.418,461,1294,.356,2193,5054,.434,1237,1650,.750,830,2419,3249,1574,604,402,1164,1748,7006,85.4
28,Utah Jazz,82,19780,2690,6172,.436,252,786,.321,2438,5386,.453,1639,2196,.746,1103,2272,3375,1671,583,494,1365,2096,7271,88.7
29,Washington Wizards,82,19830,2758,6556,.421,433,1269,.341,2325,5287,.440,1579,2211,.714,1115,2392,3507,1537,733,406,1439,1712,7528,91.8